1111111111
10000000C1
11101X1111
1PC01EX001
1111111111