1111111111
10000000C1
1110001111
1PC01E0001
1111111111