1111111111
1000P000C1
100000C001
10C00E0001
1111111111