1111111111
10000000C1
1110101111
1PC01E0001
1111111111