1111111111
1000P00001
1000000001
1C00E000C1
1111111111