1111111111111111111111111111111111
1E0000000000000C00000C000000000001
101001010010X00010100100X00X010101
101001X010101010001001000000010101
1P0000000C00C000000000000000X000C1
1111111111111111111111111111111111